Kids_First_Biospecimen_ID	pathology_diagnosis_latest	pathology_diagnosis_previous
BS_0AK4F99X	Brainstem glioma- Diffuse intrinsic pontine glioma	Diffuse Astrocytoma
BS_0ATJ22QA	Brainstem glioma- Diffuse intrinsic pontine glioma	Anaplastic Astrocytoma
BS_0ZA67BBC	Brainstem glioma- Diffuse intrinsic pontine glioma	Anaplastic Astrocytoma
BS_169P1QCA	Brainstem glioma- Diffuse intrinsic pontine glioma	Diffuse midline glioma, H3K27M mutant, WHO grade IV
BS_18RH1034	High-grade glioma/astrocytoma (WHO grade III/IV)	High Grade Glioma
BS_1MME7FBS	Brainstem glioma- Diffuse intrinsic pontine glioma	Diffuse Astrocytoma
BS_1N7MQZGR	Brainstem glioma- Diffuse intrinsic pontine glioma	Diffuse Astrocytoma
BS_1Q524P3B	Brainstem glioma- Diffuse intrinsic pontine glioma	Anaplastic Astrocytoma
BS_1RTE2KEX	Brainstem glioma- Diffuse intrinsic pontine glioma	Anaplastic Astrocytoma
BS_21ET39G7	Brainstem glioma- Diffuse intrinsic pontine glioma	Anaplastic Astrocytoma
BS_22VCR7DF	Brainstem glioma- Diffuse intrinsic pontine glioma	Anaplastic Astrocytoma
BS_2853394H	High-grade glioma/astrocytoma (WHO grade III/IV)	Pilocytic Astrocytoma
BS_2B6ZEXAP	High-grade glioma/astrocytoma (WHO grade III/IV)	NA
BS_2DNGDW0A	High-grade glioma/astrocytoma (WHO grade III/IV)	High Grade Glioma
BS_2HDEZFTW	Brainstem glioma- Diffuse intrinsic pontine glioma	Diffuse midline glioma, H3K27M mutant, WHO grade IV
BS_2HNXVFAS	High-grade glioma/astrocytoma (WHO grade III/IV)	Diffuse Midline Glioma H2K27M WHO grade IV
BS_2JP7RBMB	Brainstem glioma- Diffuse intrinsic pontine glioma	Glioblastoma
BS_2KMB51YF	Brainstem glioma- Diffuse intrinsic pontine glioma	Diffuse midline glioma, H3K27M mutant, WHO grade IV
BS_2NDRETB2	Brainstem glioma- Diffuse intrinsic pontine glioma	Diffuse Astrocytoma
BS_2X60Q1ET	Brainstem glioma- Diffuse intrinsic pontine glioma	Anaplastic Astrocytoma
BS_328C4BW5	Brainstem glioma- Diffuse intrinsic pontine glioma	Glioma
BS_38CD519Z	Brainstem glioma- Diffuse intrinsic pontine glioma	Diffuse midline glioma, H3K27M mutant, WHO grade IV
BS_3EZR108Y	High-grade glioma/astrocytoma (WHO grade III/IV)	NA
BS_3VKW5988	Brainstem glioma- Diffuse intrinsic pontine glioma	Infiltrating Diffuse Astrocytoma
BS_3Z40EZHD	Brainstem glioma- Diffuse intrinsic pontine glioma	Anaplastic Astrocytoma
BS_3ZPJAK9A	High-grade glioma/astrocytoma (WHO grade III/IV)	Diffuse midline glioma, Grade IV
BS_402W79TS	Brainstem glioma- Diffuse intrinsic pontine glioma	Infiltrating Diffuse Astrocytoma
BS_40RVSGZF	High-grade glioma/astrocytoma (WHO grade III/IV)	NA
BS_49CJNZ06	Brainstem glioma- Diffuse intrinsic pontine glioma	High Grade Glial Neoplasma
BS_4DQAQFQH	Brainstem glioma- Diffuse intrinsic pontine glioma	Diffuse Astrocytoma
BS_4DYW3T2A	Brainstem glioma- Diffuse intrinsic pontine glioma	Diffuse midline glioma, H3K27M mutant, WHO grade IV
BS_4GKH983E	Glial-neuronal tumor NOS	Low-grade glioma/astrocytoma (WHO grade I/II)
BS_4K7SDXC7	High-grade glioma/astrocytoma (WHO grade III/IV)	Diffuse midline glioma, Grade IV
BS_4KNBXM3C	High-grade glioma/astrocytoma (WHO grade III/IV)	Diffuse midline glioma, Grade IV
BS_4NPEMNAD	Metastatic secondary tumors;Neuroblastoma	Neuroblastoma
BS_4PM2QG9C	Brainstem glioma- Diffuse intrinsic pontine glioma	Diffuse midline glioma, H3K27M mutant, WHO grade IV
BS_4SCDT7M9	High-grade glioma/astrocytoma (WHO grade III/IV)	Diffuse Midline Glioma
BS_52ETE050	Brainstem glioma- Diffuse intrinsic pontine glioma	Diffuse Astrocytoma
BS_541KKASA	Brainstem glioma- Diffuse intrinsic pontine glioma	Diffuse Astrocytoma
BS_5968GBGT	Brainstem glioma- Diffuse intrinsic pontine glioma	Infiltrating Diffuse Astrocytoma
BS_5AJNFDME	High-grade glioma/astrocytoma (WHO grade III/IV)	NA
BS_5CCAC8TZ	Brainstem glioma- Diffuse intrinsic pontine glioma	High Grade Glioma
BS_5FBN4PPQ	Brainstem glioma- Diffuse intrinsic pontine glioma	High Grade Glial Neoplasma
BS_5VPM0F36	Brainstem glioma- Diffuse intrinsic pontine glioma	Diffuse Astrocytoma
BS_5Z0GA574	Brainstem glioma- Diffuse intrinsic pontine glioma	Glioblastoma
BS_63WRZJ06	High-grade glioma/astrocytoma (WHO grade III/IV)	NA
BS_6687ZNGS	Brainstem glioma- Diffuse intrinsic pontine glioma	Diffuse Astrocytoma
BS_682Z7WH6	Brainstem glioma- Diffuse intrinsic pontine glioma	High Grade Glial Neoplasma
BS_68KX6A42	Brainstem glioma- Diffuse intrinsic pontine glioma	Glioblastoma
BS_6B62YT97	Brainstem glioma- Diffuse intrinsic pontine glioma	Anaplastic Astrocytoma
BS_6DT506HY	Brainstem glioma- Diffuse intrinsic pontine glioma	Diffuse Astrocytoma
BS_6JBE0947	Brainstem glioma- Diffuse intrinsic pontine glioma	Diffuse Astrocytoma
BS_6M2053M0	Brainstem glioma- Diffuse intrinsic pontine glioma	Diffuse Astrocytoma
BS_6VTQ3W4M	Brainstem glioma- Diffuse intrinsic pontine glioma	Anaplastic Astrocytoma
BS_6ZP2KRPW	Ependymoma	Dysembryoplastic neuroepithelial tumor (DNET)
BS_74SJ7YV4	Brainstem glioma- Diffuse intrinsic pontine glioma	Diffuse midline glioma, H3K27M mutant, WHO grade IV
BS_74TZJTW0	Brainstem glioma- Diffuse intrinsic pontine glioma	Diffuse midline glioma, H3K27M mutant, WHO grade IV
BS_7G3AFSCR	Brainstem glioma- Diffuse intrinsic pontine glioma	Anaplastic Astrocytoma
BS_7GKF6M85	Brainstem glioma- Diffuse intrinsic pontine glioma	Diffuse Astrocytoma
BS_7KR13R3P	Brainstem glioma- Diffuse intrinsic pontine glioma	Infiltrating Dipg
BS_7PAAZQE6	High-grade glioma/astrocytoma (WHO grade III/IV)	Anaplastic Astrocytoma
BS_7PF3C1P7	Brainstem glioma- Diffuse intrinsic pontine glioma	Diffuse Astrocytoma
BS_7WM3MNZ0	Brainstem glioma- Diffuse intrinsic pontine glioma	Diffuse midline glioma, H3K27M mutant, WHO grade IV
BS_862NMAR7	High-grade glioma/astrocytoma (WHO grade III/IV)	Diffuse Midline Glioma
BS_8BNM6DE1	High-grade glioma/astrocytoma (WHO grade III/IV)	NA
BS_8SYN7GXG	Brainstem glioma- Diffuse intrinsic pontine glioma	Anaplastic Astrocytoma
BS_8ZE4Z9G5	High-grade glioma/astrocytoma (WHO grade III/IV)	Glioblastoma (WHO grade 4)
BS_8ZY4GST0	Brainstem glioma- Diffuse intrinsic pontine glioma	Infiltrating Dipg
BS_91HP99HY	High-grade glioma/astrocytoma (WHO grade III/IV)	High Grade Glioma
BS_9CA93S6D	Brainstem glioma- Diffuse intrinsic pontine glioma	Not Reported
BS_9DN4QR6E	Brainstem glioma- Diffuse intrinsic pontine glioma	Anaplastic Astrocytoma
BS_9FX3YREK	High-grade glioma/astrocytoma (WHO grade III/IV)	Diffuse Midline Glioma
BS_9P4NDTKJ	Brainstem glioma- Diffuse intrinsic pontine glioma	Diffuse Astrocytoma
BS_9TXEDSWB	High-grade glioma/astrocytoma (WHO grade III/IV)	high grade astrocytoma WHO IV
BS_9W04ZPRR	High-grade glioma/astrocytoma (WHO grade III/IV)	Glioblastoma
BS_A6YJ3WG2	Brainstem glioma- Diffuse intrinsic pontine glioma	Diffuse Astrocytoma
BS_AEEKJ1QK	Brainstem glioma- Diffuse intrinsic pontine glioma	Diffuse Astrocytoma
BS_AF5D41PD	Brainstem glioma- Diffuse intrinsic pontine glioma	Infiltrating Diffuse Astrocytoma
BS_AHAXPFG3	Brainstem glioma- Diffuse intrinsic pontine glioma	Diffuse Astrocytoma
BS_AK9BV52G	Brainstem glioma- Diffuse intrinsic pontine glioma	Anaplastic Astrocytoma
BS_APXB3MQ5	High-grade glioma/astrocytoma (WHO grade III/IV)	NA
BS_B19AWBBW	Brainstem glioma- Diffuse intrinsic pontine glioma	Diffuse midline glioma, H3K27M mutant, WHO grade IV
BS_B4PPG3X5	Brainstem glioma- Diffuse intrinsic pontine glioma	Anaplastic Astrocytoma
BS_B4R7X1KE	High-grade glioma/astrocytoma (WHO grade III/IV)	High Grade Glioma, Grade 4
BS_BQ81D2BP	Brainstem glioma- Diffuse intrinsic pontine glioma	Infiltrating Diffuse Astrocytoma
BS_BT83BCEE	High-grade glioma/astrocytoma (WHO grade III/IV)	Glioblastoma
BS_C83TK159	Brainstem glioma- Diffuse intrinsic pontine glioma	Anaplastic Astrocytoma
BS_CBMAWSAR	Brainstem glioma- Diffuse intrinsic pontine glioma	Diffuse midline glioma, H3K27M mutant, WHO grade IV
BS_CD7AXQM8	Brainstem glioma- Diffuse intrinsic pontine glioma	No path report
BS_CFJYJAA3	High-grade glioma/astrocytoma (WHO grade III/IV)	NA
BS_CGXTFM67	Brainstem glioma- Diffuse intrinsic pontine glioma	Diffuse Astrocytoma
BS_CX6KACX6	Brainstem glioma- Diffuse intrinsic pontine glioma	Glioblastoma
BS_CZPQ493E	High-grade glioma/astrocytoma (WHO grade III/IV)	DMG H3 K27M-Mutant WHO Grade IV
BS_D6STCMQS	Brainstem glioma- Diffuse intrinsic pontine glioma	Anaplastic Astrocytoma
BS_DD2N8CEX	High-grade glioma/astrocytoma (WHO grade III/IV)	High Grade Glioma
BS_DRVEFVQ5	Brainstem glioma- Diffuse intrinsic pontine glioma	Anaplastic Astrocytoma
BS_DVDT4VXQ	Brainstem glioma- Diffuse intrinsic pontine glioma	Anaplastic Astrocytoma
BS_DY88N5ZT	Metastatic secondary tumors;Neuroblastoma	Neuroblastoma
BS_E7NVYA6G	High-grade glioma/astrocytoma (WHO grade III/IV)	High Grade Glioma
BS_EE73VE7V	Brainstem glioma- Diffuse intrinsic pontine glioma	Infiltrating Diffuse Astrocytoma
BS_EVCAC3NH	Ependymoma	Dysembryoplastic neuroepithelial tumor (DNET)
BS_EZ3147MX	Brainstem glioma- Diffuse intrinsic pontine glioma	High Grade Glioma
BS_F0GNWEJJ	Metastatic secondary tumors;Neuroblastoma	Neuroblastoma
BS_F0JB4EAK	Brainstem glioma- Diffuse intrinsic pontine glioma	Diffuse Astrocytoma
BS_F9Y4Z92G	High-grade glioma/astrocytoma (WHO grade III/IV)	High Grade Glioma
BS_FCDAH728	Brainstem glioma- Diffuse intrinsic pontine glioma	Anaplastic Astrocytoma
BS_FK3B5SDH	Brainstem glioma- Diffuse intrinsic pontine glioma	Diffuse Astrocytoma
BS_FWP8ZA4K	Brainstem glioma- Diffuse intrinsic pontine glioma	Anaplastic Astrocytoma
BS_G3NN392N	Brainstem glioma- Diffuse intrinsic pontine glioma	Diffuse Astrocytoma
BS_G5NHSFD4	High-grade glioma/astrocytoma (WHO grade III/IV)	Anaplastic Astrocytoma
BS_G5VS97AD	High-grade glioma/astrocytoma (WHO grade III/IV)	Glioblastoma (WHO grade 4)
BS_G65EA38C	Brainstem glioma- Diffuse intrinsic pontine glioma	Glioma
BS_GBT44HST	Brainstem glioma- Diffuse intrinsic pontine glioma	Diffuse Astrocytoma
BS_GKXD33YH	Brainstem glioma- Diffuse intrinsic pontine glioma	Diffuse Astrocytoma
BS_GWSJ4Z9H	Brainstem glioma- Diffuse intrinsic pontine glioma	Anaplastic Astrocytoma
BS_H3TYF6GD	Brainstem glioma- Diffuse intrinsic pontine glioma	Anaplastic Astrocytoma
BS_H8NWA41N	Brainstem glioma- Diffuse intrinsic pontine glioma	Anaplastic Astrocytoma
BS_H97S5SQN	Brainstem glioma- Diffuse intrinsic pontine glioma	Diffuse midline glioma, H3K27M mutant, WHO grade IV
BS_HA8VYBMA	High-grade glioma/astrocytoma (WHO grade III/IV)	NA
BS_HEJ72V3F	Brainstem glioma- Diffuse intrinsic pontine glioma	Diffuse Astrocytoma
BS_HRJ9145M	High-grade glioma/astrocytoma (WHO grade III/IV)	Glioblastoma
BS_HYKV2TH9	Brainstem glioma- Diffuse intrinsic pontine glioma	Infiltrating Diffuse Astrocytoma
BS_J8EH1N7V	Brainstem glioma- Diffuse intrinsic pontine glioma	Diffuse midline glioma, H3K27M mutant, WHO grade IV
BS_J8EK6RNF	Brainstem glioma- Diffuse intrinsic pontine glioma	Diffuse Astrocytoma
BS_J9CBGP57	High-grade glioma/astrocytoma (WHO grade III/IV)	Anaplastic Astrocytoma
BS_JB43XBCQ	Brainstem glioma- Diffuse intrinsic pontine glioma	Diffuse Astrocytoma
BS_JC7E55BV	High-grade glioma/astrocytoma (WHO grade III/IV)	Diffuse Midline Glioma H2K27M WHO grade IV
BS_JCWD4DMA	Brainstem glioma- Diffuse intrinsic pontine glioma	Diffuse midline glioma, H3K27M mutant, WHO grade IV
BS_JD05XR6E	Brainstem glioma- Diffuse intrinsic pontine glioma	Diffuse midline glioma, H3K27M mutant, WHO grade IV
BS_JD5FE0V5	High-grade glioma/astrocytoma (WHO grade III/IV)	Anaplastic Astrocytoma
BS_JDZX545X	Brainstem glioma- Diffuse intrinsic pontine glioma	Diffuse midline glioma, H3K27M mutant, WHO grade IV
BS_JQVAWTTM	Brainstem glioma- Diffuse intrinsic pontine glioma	Diffuse Astrocytoma
BS_JRFVST47	Brainstem glioma- Diffuse intrinsic pontine glioma	Anaplastic Astrocytoma
BS_JTWNJ8T7	High-grade glioma/astrocytoma (WHO grade III/IV)	Glioblastoma
BS_JWDK21ED	High-grade glioma/astrocytoma (WHO grade III/IV)	High Grade Glioma
BS_K07KNTFY	Other	Medulloblastoma
BS_KHJMCFQR	High-grade glioma/astrocytoma (WHO grade III/IV)	Diffuse Midline Glioma
BS_KN6FCN12	High-grade glioma/astrocytoma (WHO grade III/IV)	NA
BS_KPG4WCHS	Brainstem glioma- Diffuse intrinsic pontine glioma	Glioblastoma
BS_KQRAHH6Y	Brainstem glioma- Diffuse intrinsic pontine glioma	Glioblastoma
BS_KRS4EV4X	High-grade glioma/astrocytoma (WHO grade III/IV)	Grade IV Glioblastoma
BS_KT3GAAQV	High-grade glioma/astrocytoma (WHO grade III/IV)	Grade IV Glioblastoma
BS_KWMFKN38	High-grade glioma/astrocytoma (WHO grade III/IV)	NA
BS_M0B42FPR	Brainstem glioma- Diffuse intrinsic pontine glioma	Diffuse Astrocytoma
BS_M5FM63EB	Brainstem glioma- Diffuse intrinsic pontine glioma	Diffuse Astrocytoma
BS_MQCKXD60	Glial-neuronal tumor NOS	Low-grade glioma/astrocytoma (WHO grade I/II)
BS_NB9XXBW6	Brainstem glioma- Diffuse intrinsic pontine glioma	Diffuse Astrocytoma
BS_NEVYM2FP	Brainstem glioma- Diffuse intrinsic pontine glioma	Glioma
BS_NGHQ8CNA	High-grade glioma/astrocytoma (WHO grade III/IV)	NA
BS_NGSG2KB6	Brainstem glioma- Diffuse intrinsic pontine glioma	Infiltrating Diffuse Astrocytoma
BS_NNFDFAFM	Brainstem glioma- Diffuse intrinsic pontine glioma	Infiltrating Dipg
BS_P78BDBZE	High-grade glioma/astrocytoma (WHO grade III/IV)	NA
BS_P7VR731D	Brainstem glioma- Diffuse intrinsic pontine glioma	Diffuse midline glioma, H3K27M mutant, WHO grade IV
BS_PJZ7YCFW	High-grade glioma/astrocytoma (WHO grade III/IV)	NA
BS_Q6GVRAWK	Brainstem glioma- Diffuse intrinsic pontine glioma	Anaplastic Astrocytoma
BS_QF7M4SHH	High-grade glioma/astrocytoma (WHO grade III/IV)	High Grade Glioma
BS_QFH9XM6Q	Brainstem glioma- Diffuse intrinsic pontine glioma	High Grade Glioma
BS_QNNX91SM	Brainstem glioma- Diffuse intrinsic pontine glioma	Glioblastoma
BS_QTF9SJGP	High-grade glioma/astrocytoma (WHO grade III/IV)	NA
BS_QWNBZ9RJ	Other	Medulloblastoma
BS_QZPGVNBB	Brainstem glioma- Diffuse intrinsic pontine glioma	Glioblastoma
BS_QZRP3NSG	Brainstem glioma- Diffuse intrinsic pontine glioma	Diffuse Astrocytoma
BS_R6CKWZW6	Brainstem glioma- Diffuse intrinsic pontine glioma	High Grade Glial Neoplasma
BS_R7NTZR4C	Brainstem glioma- Diffuse intrinsic pontine glioma	Anaplastic Astrocytoma
BS_R9B92M75	Brainstem glioma- Diffuse intrinsic pontine glioma	Diffuse midline glioma, H3K27M mutant, WHO grade IV
BS_RJC3WDD6	High-grade glioma/astrocytoma (WHO grade III/IV)	High Grade Glioma
BS_RP8JJ88Z	High-grade glioma/astrocytoma (WHO grade III/IV)	NA
BS_RVT7EHNX	High-grade glioma/astrocytoma (WHO grade III/IV)	NA
BS_RWJ0571Q	Brainstem glioma- Diffuse intrinsic pontine glioma	Glioblastoma
BS_S8A23A9V	High-grade glioma/astrocytoma (WHO grade III/IV)	NA
BS_TN8CGS84	High-grade glioma/astrocytoma (WHO grade III/IV)	Diffuse Midline Glioma H2K27M WHO grade IV
BS_TQ0J7WJQ	Brainstem glioma- Diffuse intrinsic pontine glioma	Diffuse Astrocytoma
BS_TVXSXJFY	High-grade glioma/astrocytoma (WHO grade III/IV)	NA
BS_TYFD8ZMG	Brainstem glioma- Diffuse intrinsic pontine glioma	Diffuse Astrocytoma
BS_VCE73HPW	Brainstem glioma- Diffuse intrinsic pontine glioma	Diffuse midline glioma, H3K27M mutant, WHO grade IV
BS_VKYEM67A	High-grade glioma/astrocytoma (WHO grade III/IV)	High Grade Glioma
BS_VNWKNRY4	Metastatic secondary tumors;Neuroblastoma	Neuroblastoma
BS_VXDGXQKZ	Brainstem glioma- Diffuse intrinsic pontine glioma	Anaplastic Astrocytoma
BS_W7MFJZ5A	Brainstem glioma- Diffuse intrinsic pontine glioma	Diffuse Astrocytoma
BS_WNDCJVC6	High-grade glioma/astrocytoma (WHO grade III/IV)	NA
BS_WPV7N6NQ	High-grade glioma/astrocytoma (WHO grade III/IV)	High Grade Glioma
BS_WQ1YRTAT	High-grade glioma/astrocytoma (WHO grade III/IV)	High Grade Glioma
BS_WYTDVC0Y	Brainstem glioma- Diffuse intrinsic pontine glioma	Diffuse Astrocytoma
BS_X0KN4VVW	High-grade glioma/astrocytoma (WHO grade III/IV)	high grade astrocytoma WHO IV
BS_X4DD4KSZ	Brainstem glioma- Diffuse intrinsic pontine glioma	Diffuse midline glioma, H3K27M mutant, WHO grade IV
BS_X5VN0FW0	Brainstem glioma- Diffuse intrinsic pontine glioma	Anaplastic Astrocytoma
BS_X6H86RTA	Brainstem glioma- Diffuse intrinsic pontine glioma	Glioblastoma
BS_X8YB5G5J	High-grade glioma/astrocytoma (WHO grade III/IV)	DMG H3 K27M-Mutant WHO Grade IV
BS_XGDPK33A	Brainstem glioma- Diffuse intrinsic pontine glioma	Diffuse midline glioma, H3K27M mutant, WHO grade IV
BS_XM1AHBDJ	Brainstem glioma- Diffuse intrinsic pontine glioma	Anaplastic Astrocytoma
BS_XM3ER1N6	High-grade glioma/astrocytoma (WHO grade III/IV)	NA
BS_XNYH7VK6	High-grade glioma/astrocytoma (WHO grade III/IV)	High Grade Glioma, Grade 4
BS_XPZAD9PP	Brainstem glioma- Diffuse intrinsic pontine glioma	Diffuse midline glioma, H3K27M mutant, WHO grade IV
BS_XV5XFKE8	High-grade glioma/astrocytoma (WHO grade III/IV)	NA
BS_Y0DGBKTY	Brainstem glioma- Diffuse intrinsic pontine glioma	Anaplastic Astrocytoma
BS_Y74XAFJX	Brainstem glioma- Diffuse intrinsic pontine glioma	Diffuse midline glioma, H3K27M mutant, WHO grade IV
BS_Y96RP1HJ	Brainstem glioma- Diffuse intrinsic pontine glioma	Anaplastic Astrocytoma
BS_YA0KMBRT	High-grade glioma/astrocytoma (WHO grade III/IV)	High Grade Glioma
BS_YDEVMD24	Brainstem glioma- Diffuse intrinsic pontine glioma	Diffuse Astrocytoma
BS_YHXMYDBN	Brainstem glioma- Diffuse intrinsic pontine glioma	Anaplastic Astrocytoma
BS_YZD4SSMA	Brainstem glioma- Diffuse intrinsic pontine glioma	Infiltrating Dipg
BS_Z3AB3KMP	Brainstem glioma- Diffuse intrinsic pontine glioma	Diffuse midline glioma, H3K27M mutant, WHO grade IV
BS_Z3RCA1T9	Brainstem glioma- Diffuse intrinsic pontine glioma	Diffuse midline glioma, H3K27M mutant, WHO grade IV
BS_Z61JVJ03	High-grade glioma/astrocytoma (WHO grade III/IV)	Pilocytic Astrocytoma
BS_Z64NEPNE	Brainstem glioma- Diffuse intrinsic pontine glioma	Diffuse Astrocytoma
BS_Z8GRJ71M	High-grade glioma/astrocytoma (WHO grade III/IV)	Diffuse midline glioma, Grade IV
BS_ZF6BSFNF	Brainstem glioma- Diffuse intrinsic pontine glioma	Diffuse midline glioma, H3K27M mutant, WHO grade IV
BS_ZSH09N84	Brainstem glioma- Diffuse intrinsic pontine glioma	Diffuse midline glioma, H3K27M mutant, WHO grade IV
